

sn27[53322]/0
    sum12-bits:
        47  46  43  33  25  11
---------
sn30[59428]/1
    sum12-bits:
        54  50  45  25  24
----------
sn33[563712]/4
    sum12-bits:
        44  32  26  22  19  18   4
----------
sn36[302110]/0
    sum12-bits:
        47 46 43 42 41 38 34 33 26 24 22 19 18 13 12 11  8
----------
sn39[40237]/3
    sum12-bits:
        50 48 46 43 42 38 34 33 32 26 25 19 18 11 2
----------
sn42[31170]/6
    sum12-bits:
        57 56 48 45 44 43 42 40 38 33 27 26 25 24 22 21 19 10 8 4 2
----------
sn45[492928]/1
    sum12-bits:
        54 53 50 48 47 44 36 34 32 31 30 27 23 22 21 19 18 13 12 11 10 0
----------
sn48[525135]/0
    sum12-bits:
        57 56 54 50 48 46 44 42 40 38 36 34 33 32 31 27 24 23 22 21 19 18 17 13 11 10 4 0
----------
sn51[39209]/0
    sum12-bits:
        59 57 54 53 52 51 49 48 47 46 45 44 43 42 38 37 36 35 33 32 31 29 28 27 26 23 21 19 17 13 12 11 10 8 7 4 2 0]
----------
sn54[55153]/7
    sum12-bits:
        57 56 54 53 52 51 49 47 46 43 42 40 38 37 36 35 34 33 31 30 28 26 25 24 22 21 20 19 18 17 13 12 11 10 9 8 7 4 2
----------
sn57[58145]/1
    sum12-bits:
        59 57 55 53 52 51 50 48 47 46 45 44 42 41  40 39 38 36 35 34 32 31 30 29 28 27 26 25 23 22 21 20 19 18 17 13 12 11 10 8 7  4  3  2  0
----------
sn60[1661]/05
    sum12-bits:
        59   57   56   54   53   51   50   47   46   45   44   43   39   38   36   35   32   31   30   29   28   27   26   25   24   23   21   20   19   17   15   14   13   12   11   10   9   8   7   5   4   2
 57          1,1                                          ,1                  ,3   ,1             3,1       1,        1,1                                                              1, 
 54
 51
 48
 45
 42
 39
 36
 33
 30
 27
 24
 21